code	label
GER	Allemand
ENG	Anglais
ARA	Arabe
BUL	Bulgare
CHI	Chinois
DAN	Danois
SPA	Espagnol
FIN	Finnois
FRE	Français
GRE	Grec
HUN	Hongrois
UND	Inconnue
ICE	Islandais
ITA	Italien
JPN	Japonais
LAV	Letton
LIT	Lithuanien
MUL	Multilingue
DUT	Néerlandais
NOR	Norvégien
POL	Polonais
POR	Portugais
RUM	Roumain
RUS	Russe
SLO	Slovaque
SLV	Slovène
SWE	Suédois
CZE	Tchèque
TUR	Turc
UKR	Ukrainien
VIE	Vietnamien
